8 16
AAAABBBF     LLL
C  E   F HIIIK M
C  E   F H   K M
C  E   F H   K M
CDDDDDDF HJJJKNM
C      F H   K  
C      F H   K  
CGGGGGGGGGGGGK  
500 200
20 5 2 3 5 8 12 16 21 26 32 40
20 6 2 3 5 8 12 17 23 29 36 45
15 3 1 2 4 6 8 10 13 16 19 23
23 5 3 5 7 9 12 15 19 23 27 32
10 2 1 2 3 4 5 6 7 9 12 15
18 3 1 2 4 7 10 14 18 23 28 35
25 8 1 3 5 7 9 11 13 15 17 20
18 4 1 2 4 7 10 14 19 24 30 38
12 3 3 4 5 6 7 8 10 12 14 17
15 2 4 5 6 7 8 9 10 11 12 13
15 3 2 4 6 9 12 15 19 23 28 33
30 7 3 6 10 15 20 25 33 40 50 65
30 6 3 6 10 14 19 24 29 35 42 50
30 7 5 10 16 23 32 42 55 70 88 105