17 17
AAAA         BBBB
AAAA         BBBB
AAAA         BBBB
AAAAEEEEEEEEEBBBB
   F    J    H   
   F    J    H   
   F    J    H   
   F   MMM   H   
   FIIIMMMKKKH   
   F   MMM   H   
   F    L    H   
   F    L    H   
   F    L    H   
CCCCGGGGGGGGGDDDD
CCCC         DDDD
CCCC         DDDD
CCCC         DDDD
1000 500
20 6 1 3 5 8 11 15 20 26 33 40
20 6 1 3 5 8 11 15 20 26 33 40
20 6 1 3 5 8 11 15 20 26 33 40
20 6 1 3 5 8 11 15 20 26 33 40
30 5 2 4 7 11 15 19 24 30 38 48
30 5 2 4 7 11 15 19 24 30 38 48
30 5 2 4 7 11 15 19 24 30 38 48
30 5 2 4 7 11 15 19 24 30 38 48
40 5 3 6 9 13 17 22 27 35 45 60
40 5 3 6 9 13 17 22 27 35 45 60
40 5 3 6 9 13 17 22 27 35 45 60
40 5 3 6 9 13 17 22 27 35 45 60
40 8 2 5 8 12 16 20 25 30 38 45