15 15
AAA   BBB   CCC
AAATTTBBBUUUCCC
AAA   BBB   CCC
 J     K     L 
 J     K     L 
 J     K     L 
DDD   EEE   FFF
DDDMMMEEENNNFFF
DDD   EEE   FFF
 O     P     Q 
 O     P     Q 
 O     P     Q 
GGG   HHH   III
GGGRRRHHHSSSIII
GGG   HHH   III
1500 500
15 3 1 2 4 7 12 20 36 64 100 150
20 5 1 3 6 12 24 45 90 150 250 400
15 3 1 2 4 7 12 20 36 64 100 150
20 5 1 3 6 12 24 45 90 150 250 400
35 8 2 4 8 16 30 60 110 200 400 700
20 5 1 3 6 12 24 45 90 150 250 400
15 3 1 2 4 7 12 20 36 64 100 150
20 5 1 3 6 12 24 45 90 150 250 400
15 3 1 2 4 7 12 20 36 64 100 150
18 3 3 8 18 36 70 130 200 300 500 800
27 4 4 10 20 40 75 150 250 400 600 1000
18 3 3 8 18 36 70 130 200 300 500 800
27 4 4 10 20 40 75 150 250 400 600 1000
27 4 4 10 20 40 75 150 250 400 600 1000
18 3 3 8 18 36 70 130 200 300 500 800
27 4 4 10 20 40 75 150 250 400 600 1000
18 3 3 8 18 36 70 130 200 300 500 800
18 3 3 8 18 36 70 130 200 300 500 800
18 3 3 8 18 36 70 130 200 300 500 800
18 3 3 8 18 36 70 130 200 300 500 800
18 3 3 8 18 36 70 130 200 300 500 800