15 13
OAAAAAAAAAAAP
O E F G H I P
O E F G H I P
O E F G H I P
O E F G H I P
O E F G H I P
OBBBBBBBBBBBP
O           P
OCCCCCCCCCCCP
O J K L M N P
O J K L M N P
O J K L M N P
O J K L M N P
O J K L M N P
ODDDDDDDDDDDP
1500 500
20 3 2 4 7 12 20 30 45 80 150 250
20 3 2 4 7 12 20 30 45 80 150 250
20 3 2 4 7 12 20 30 45 80 150 250
20 3 2 4 7 12 20 30 45 80 150 250
30 4 3 8 15 30 60 110 200 400 700 1200
30 4 3 8 15 30 60 110 200 400 700 1200
30 4 3 8 15 30 60 110 200 400 700 1200
30 4 3 8 15 30 60 110 200 400 700 1200
30 4 3 8 15 30 60 110 200 400 700 1200
30 4 3 8 15 30 60 110 200 400 700 1200
30 4 3 8 15 30 60 110 200 400 700 1200
30 4 3 8 15 30 60 110 200 400 700 1200
30 4 3 8 15 30 60 110 200 400 700 1200
30 4 3 8 15 30 60 110 200 400 700 1200
22 3 1 3 6 10 15 25 40 70 130 220
22 3 1 3 6 10 15 25 40 70 130 220