17 8
AKKKKKKD
A      D
A      D
A      D
A      D
GG    II
GG    II
 B    E 
 B    E 
 B    E 
HH    JJ
HH    JJ
C      F
C      F
C      F
C      F
CLLLLLLF
2000 500
20 3 2 5 10 20 42 90 200 400 750 1500
10 1 1 2 4 8 16 35 70 150 300 600
15 3 2 4 9 18 38 78 160 330 680 1300
22 4 3 7 15 30 62 125 250 500 1050 2200
30 5 4 10 25 50 120 250 510 1080 2300 5000
18 2 1 3 6 14 30 60 122 245 490 1000
10 2 1 2 4 8 16 30 58 110 200 350
8 1 1 2 3 5 9 17 35 60 100 200
21 3 3 6 12 20 40 75 130 250 480 1000
13 2 1 3 6 11 22 40 74 125 233 450
18 2 2 4 8 16 33 66 133 268 538 1100
12 2 1 3 6 12 24 49 99 200 410 830